{ "stageData" :

    {
    "stage" : 4,
    "bg" : 1,
    "hammer" : 1,
    

    "char" : [
		{"type" : 1, "per" : 60},
        {"type" : 2, "per" : 40}
    ],

    "item" : [
    ],

    "wordSet" : [
        {"type" : 1, "per" : 100, "data" : 
            [
        	   "각", "간", "감", "갑", "갓", "강", "난", "남", "낫", "낮", 
                "달", "담", "답", "당", "닻", "만", "맘", "맛", "망", "반", 
                "발", "밤", "밥", "방", "밭", "산", "살", "삼", "삽", "상", 
                "샄", "안", "알", "암", "잔", "잠", "잣", "장", "찬", "참", 
                "창", "칸", "탕", "판", "팔", "팥", "학", "한", "함", "합", 
                "검", "겁", "것", "겉", "넌", "널", "덕", "덤", "덫", "먹", 
                "멋", "멍", "번", "벌", "법", "벚", "선", "설", "섬", "성", 
                "섶", "억", "얼", "업", "적", "전", "절", "점", "젓", "정", 
                "젖", "척", "천", "철", "첩", "청", "턱", "털", "헌", "골", 
                "공", "곹", "논", "놈", "돈", "동", "돛", "목", "못", "몾", 
                "복", "볼", "봄", "속", "손", "솔", "솜", "솥", "옷", "옻", 
                "좀", "종", "총", "콩", "통", "혹", "혼", "홈", "홍", "눈", 
                "둑", "둘", "묵", "문", "물", "북", "분", "불", "붓", "순", 
                "술", "숨", "숯", "운", "울", "웁", "웃", "죽", "줄", "줌", 
                "중", "축", "춤", "풀", "풍", "객", "댁", "댐", "맥", "백", 
                "뱀", "샘", "핵", "셈", "글", "금", "늘", "들", "음", "즉", 
                "즙", "큼", "틀", "틈", "흠", "김", "깁", "깃", "님", "빗", 
                "빚", "빛", "신", "실", "심", "십", "일", "입", "잎", "진", 
                "짐", "집", "징", "짚", "칠", "침", "힘", "뵤", "벼", "뱌", 
                "배", "베", "보", "버", "바", "비", "뷰", "부", "브", "죠", 
                "져", "쟈", "재", "제", "조", "저", "자", "지", "쥬", "주", 
                "즈", "됴", "뎌", "댜", "대", "데", "도", "더", "다", "디", 
                "듀", "두", "드", "교", "겨", "갸", "개", "게", "고", "거", 
                "가", "기", "규", "구", "그", "쇼", "셔", "샤", "새", "세", 
                "소", "서", "사", "시", "슈", "수", "스", "묘", "며", "먀", 
                "매", "메", "모", "머", "마", "미", "뮤", "무", "므", "뇨", 
                "녀", "냐", "내", "네", "노", "너", "나", "니", "뉴", "누", 
                "느", "요", "여", "야", "애", "에", "오", "어", "아", "이", 
                "유", "우", "으", "료", "려", "랴", "래", "레", "로", "러", 
                "라", "리", "류", "루", "르", "효", "혀", "햐", "해", "헤", 
                "호", "허", "하", "히", "휴", "후", "흐", "쿄", "켜", "캬", 
                "캐", "케", "코", "커", "카", "키", "큐", "쿠", "크", "툐", 
                "텨", "탸", "태", "테", "토", "터", "타", "티", "튜", "투", 
                "트", "쵸", "쳐", "챠", "채", "체", "초", "처", "차", "치", 
                "츄", "추", "츠", "표", "펴", "퍄", "패", "페", "포", "퍼", 
                "파", "피", "퓨", "푸", "프","곰", "공", "구", "국", "꾀",
                "끝", "나", "너", "돌", "떡", "무", "물", "밥", "밭"
            ]
        }
    ],

    "showTime" : {"min" : 10, "max" : 10},
    
    "playLimitTime" : 60
}
}